111111
100001
10CPP1
1E0001
111111
