111111
100001
1EPC01
111111
1
