11111111111111111111
100000100000000000E1
10000000000000000001
10000000000000000001
10010000000000000001
10000001000000000001
10000100000000000001
10000100000000000001
10000000000000000001
1000000000000000P001
10000000C00000000001
10000000000000000001
10000000000000000001
10000000000000000001
10000000C00000000001
10000000000000000001
10000000000000000001
100000000000000C0001
10000000000000000001
11111111111111111111