11111
100C1
1P0C1
10001
10C01
100E1
10001
10001
10001
11111