1111111111
1P0000E111
1000C00011
1000C1C001
1111111111